NO ./textures/simonkraft/wet_sponge.xpm
SO ./textures/simonkraft/bookshelf.xpm
WE ./textures/simonkraft/netherrack.xpm












                EA ./textures/simonkraft/soul_sand.xpm




F 91,168,       66





C 236,245,0

                        111111111111111111111111111111
                        100000010000000000000000000001
                        101001010000000000000000000001
                        10E000000000000000000000000001
                        100000010000000000000000000001
                        111111111111100000000000000001
                                     10000000000000001
                                      100000000000001
                                       10000000000001
                                        10000000000001                
                                        10000000000001
                                        11111111111111