NO ./textures/simonkraft/cobblestone.xpm
SO ./textures/simonkraft/bookshelf.xpm
WE ./textures/simonkraft/netherrack.xpm
EA ./textures/simonkraft/soul_sand.xpm
F 220,100,0
C 225,30,0

11111111111111111
10000001000000001
10100101000000001
1010S001000000001
10000001000000001
11111111111111111