NO ./sprites/north.xpm
SO ./sprites/south.xpm
WE ./sprites/west.xpm
EA ./sprites/east.xpm
F 220,100,0
C 225,30,0

11111111
10000001
10100101
10100001
1010N001
11111111