NO ./sprites/wet_sponge.xpm
SO ./sprites/bookshelf.xpm
WE ./sprites/netherrack.xpm












                EA ./sprites/soul_sand.xpm




F 153,0,       12





C 255,155,255

                        111111111111111111111111111111
                        100000010000000000000000000001
                        101001010000000000000010000001
                        10E0000000000000000001 10000001
                        100000010000000000000010000001
                        111111111111100000000000000001
                                     100000001000000011
                                      100000000000001
                                       10000000000001
                                        10000000000001                
                                        10000000000001
                                        11111111111111